10
.......AA......A.A.A....AAA......A..
.A..A.A........A.A.A....A.A....A.A..
.....A.AA..A.A.A.......A..A..A....A.
.A..A...A.....AA.A...A..A.A.......A.
....A.AA.....A..A...AA..A........A..
A.....AA....A...AA....A.....A.......
........AA..A.A.....AA...A..A....A..
...A....AA..A.A.........AAA.A.......
A...A..A.....AA.....AA......A.......
........AA...A..A...AA...A.......A..
